+-+-+-+-+-+
    |     |
+-+ + + + +
| |   | | |
+ +-+-+-+ +
|   |     |
+-+ + +-+-+
| |       |
+ +-+-+-+ +
|          
+-+-+-+-+-+
END